...########
...#@...#.#
...#..#...#
...#....###
...#.##...#
...#....#o#
...########

